[["060000","060000","060000","060000","060000","060000","060000","060000","060000","060000","060000","060000","060000","060000","060000","060000","060000","060000","060000","060000","060000","060000","060000","060000","060000","060000","060000","060000","060000","060000","060000","060000","060000","060000","060000","060000","060000","060000","060000","060000","060000","060000","060000","060000","060000","060000","060000","060000","040000","040000"],
["060000","060000","060000","060000","060000","060000","060000","060000","060000","060000","060000","060000","060000","060000","060000","060000","060000","060000","060000","060000","060000","060000","060000","060000","060000","060000","060000","060000","060000","060000","060000","060000","060000","060000","060000","060000","060000","060000","060000","060000","060000","060000","060000","060000","060000","060000","060000","060000","040000","040000"],
["060000","060000","060000","060000","060000","060000","060000","060000","060000","060000","060000","060000","060000","060000","060000","060000","060000","060000","060000","060000","060000","060000","060000","060000","060000","060000","060000","060000","060000","060000","060000","060000","060000","060000","060000","060000","060000","060000","060000","060000","060000","060000","060000","060000","060000","060000","060000","060000","040000","040000"],
["060000","060000","060000","060000","060000","060000","060000","060000","060000","060000","060000","060000","060000","060000","060000","060000","060000","060000","060000","060000","060000","060000","060000","060000","060000","060000","060000","060000","060000","060000","060000","060000","060000","060000","060000","060000","060000","060000","060000","060000","060000","060000","060000","060000","060000","060000","060000","060000","040000","040000"],
["060000","060000","060000","060000","060000","060000","060000","060000","060000","060000","060000","060000","060000","060000","060000","060000","060000","060000","060000","060000","060000","060000","060000","060000","060000","060000","060000","060000","060000","060000","060000","060000","060000","060000","060000","060000","060000","060000","060000","060000","060000","060000","060000","060000","060000","060000","060000","060000","040000","040000"],
["060000","060000","060000","060000","060000","060000","060000","060000","060000","060000","060000","060000","060000","060000","060000","060000","060000","060000","060000","060000","060000","060000","060000","060000","060000","060000","060000","060000","060000","060000","060000","060000","060000","060000","060000","060000","060000","060000","060000","060000","060000","060000","060000","060000","060000","060000","060000","060000","040000","040000"],
["060000","060000","060000","060000","060000","060000","060000","060000","060000","060000","060000","060000","060000","060000","060000","060000","060000","060000","060000","060000","060000","060000","060000","060000","060000","060000","060000","060000","060000","060000","060000","060000","060000","060000","060000","060000","060000","060000","060000","060000","060000","060000","060000","060000","060000","060000","060000","060000","040000","040000"],
["060000","060000","050000","050000","050000","050000","060000","060000","060000","060000","060000","060000","060000","060000","060000","060000","060000","060000","060000","060000","060000","060000","060000","060000","060000","060000","060000","060000","060000","060000","060000","060000","060000","060000","060000","060000","060000","060000","060000","060000","060000","060000","060000","060000","060000","060000","060000","060000","040000","040000"],
["060000","060000","050000","050000","050000","050000","060000","060000","060000","060000","060000","060000","060000","060000","060000","060000","060000","060000","060000","060000","060000","060000","060000","060000","060000","060000","060000","060000","060000","060000","060000","060000","060000","060000","060000","060000","060000","060000","060000","060000","060000","060000","060000","060000","060000","060000","060000","060000","040000","040000"],
["060000","060000","050000","050000","050000","050000","060000","060000","060000","060000","060000","060000","060000","060000","060000","060000","060000","060000","060000","060000","060000","060000","060000","060000","060000","060000","060000","060000","060000","060000","060000","060000","060000","060000","060000","060000","060000","060000","060000","060000","060000","060000","060000","060000","060000","060000","060000","060000","040000","040000"],
["060000","060000","050000","050000","050000","050000","060000","060000","060000","060000","060000","060000","060000","060000","060000","060000","060000","060000","060000","060000","060000","060000","060000","060000","060000","060000","060000","060000","060000","060000","060000","060000","060000","060000","060000","060000","060000","060000","060000","060000","060000","060000","060000","060000","060000","060000","060000","060000","040000","040000"],
["060000","060000","060000","060000","060000","060000","060000","060000","060000","060000","060000","060000","060000","060000","060000","060000","060000","060000","060000","060000","060000","060000","060000","060000","060000","060000","060000","060000","060000","060000","060000","060000","060000","060000","060000","060000","060000","060000","060000","060000","060000","060000","060000","060000","060000","060000","060000","060000","040000","040000"],
["060000","060000","060000","060000","060000","060000","060000","060000","060000","060000","060000","060000","060000","060000","060000","060000","060000","060000","060000","060000","060000","060000","060000","060000","060000","060000","060000","060000","060000","060000","060000","060000","060000","060000","060000","060000","060000","060000","060000","060000","060000","060000","060000","060000","060000","060000","060000","060000","040000","040000"],
["060000","060000","060000","060000","060000","060000","060000","060000","060000","060000","060000","060000","060000","060000","060000","060000","060000","060000","010000","010000","010000","010000","010000","060000","060000","060000","060000","060000","060000","060000","060000","060000","060000","060000","060000","060000","060000","060000","060000","060000","060000","060000","060000","060000","060000","060000","060000","060000","040000","040000"],
["060000","060000","060000","060000","060000","060000","060000","060000","060000","060000","060000","060000","060000","060000","060000","060000","060000","060000","010000","010000","010000","010000","010000","060000","060000","060000","060000","060000","060000","060000","060000","060000","060000","060000","060000","060000","060000","060000","060000","060000","060000","060000","060000","060000","060000","060000","060000","060000","040000","040000"],
["060000","060000","060000","060000","060000","060000","060000","060000","060000","060000","060000","060000","060000","060000","060000","060000","060000","060000","010000","010000","010000","010000","010000","060000","060000","060000","060000","060000","060000","060000","060000","060000","060000","060000","060000","060000","060000","060000","060000","060000","060000","060000","060000","060000","060000","060000","060000","060000","040000","040000"],
["060000","060000","060000","060000","060000","060000","060000","060000","060000","060000","060000","060000","060000","060000","060000","060000","060000","060000","010000","010000","010000","010000","010000","060000","060000","060000","060000","060000","060000","060000","060000","060000","060000","060000","060000","060000","060000","060000","060000","060000","060000","060000","060000","060000","060000","060000","060000","060000","040000","040000"],
["060000","060000","060000","060000","060000","060000","060000","060000","060000","060000","060000","060000","060000","060000","060000","060000","060000","060000","010000","010000","010000","010000","010000","060000","060000","060000","060000","060000","060000","060000","060000","060000","060000","060000","060000","060000","060000","060000","060000","060000","060000","060000","060000","060000","060000","060000","060000","060000","040000","040000"],
["060000","060000","060000","060000","060000","060000","060000","060000","060000","060000","060000","060000","060000","060000","060000","060000","060000","060000","060000","060000","060000","060000","060000","060000","060000","060000","060000","060000","060000","060000","060000","060000","060000","060000","060000","060000","060000","060000","060000","060000","060000","060000","060000","060000","060000","060000","060000","060000","040000","040000"],
["060000","060000","060000","060000","060000","060000","060000","060000","060000","060000","060000","060000","060000","060000","060000","060000","060000","060000","060000","060000","060000","060000","060000","060000","060000","060000","060000","060000","060000","060000","060000","060000","060000","060000","060000","060000","060000","060000","060000","060000","060000","060000","060000","060000","060000","060000","060000","060000","040000","040000"],
["060000","060000","060000","060000","060000","060000","060000","060000","060000","060000","060000","060000","060000","060000","060000","060000","060000","060000","060000","060000","060000","060000","060000","060000","060000","060000","060000","060000","060000","060000","060000","060000","060000","060000","060000","060000","060000","060000","060000","060000","060000","060000","060000","060000","060000","060000","060000","060000","040000","040000"],
["060000","060000","060000","060000","060000","060000","060000","060000","060000","060000","060000","060000","060000","060000","060000","060000","060000","060000","060000","060000","060000","060000","060000","060000","060000","060000","060000","060000","060000","060000","060000","060000","060000","060000","060000","060000","060000","060000","060000","060000","060000","060000","060000","060000","060000","060000","060000","060000","040000","040000"],
["060000","060000","060000","060000","060000","060000","060000","060000","060000","060000","060000","060000","060000","060000","060000","060000","060000","060000","060000","060000","060000","060000","060000","060000","060000","060000","060000","060000","060000","060000","060000","060000","060000","060000","060000","060000","060000","060000","060000","060000","060000","060000","060000","060000","060000","060000","060000","060000","040000","040000"],
["060000","060000","060000","060000","060000","060000","060000","060000","060000","060000","060000","060000","060000","060000","060000","060000","060000","060000","060000","060000","060000","060000","060000","060000","060000","060000","060000","060000","060000","060000","060000","060000","060000","060000","060000","060000","060000","060000","060000","060000","060000","060000","060000","060000","060000","060000","060000","060000","040000","040000"],
["060000","060000","060000","060000","060000","060000","060000","060000","060000","060000","060000","060000","060000","060000","060000","060000","060000","060000","060000","060000","060000","060000","060000","060000","060000","060000","060000","060000","060000","060000","060000","060000","060000","060000","060000","060000","060000","060000","060000","060000","060000","060000","060000","060000","060000","060000","060000","060000","040000","040000"],
["060000","060000","060000","060000","060000","060000","060000","060000","060000","060000","060000","060000","060000","060000","060000","060000","060000","060000","060000","060000","060000","060000","060000","060000","060000","060000","060000","060000","060000","060000","060000","060000","060000","060000","060000","060000","060000","060000","060000","060000","060000","060000","060000","060000","060000","060000","060000","060000","040000","040000"],
["060000","060000","060000","060000","060000","060000","060000","060000","060000","060000","060000","060000","060000","060000","060000","060000","060000","060000","060000","060000","060000","060000","060000","060000","060000","060000","060000","060000","060000","060000","060000","060000","060000","060000","060000","060000","060000","060000","060000","060000","060000","060000","060000","060000","060000","060000","060000","060000","040000","040000"],
["060000","060000","060000","060000","060000","060000","060000","060000","060000","060000","060000","060000","060000","060000","060000","060000","060000","060000","060000","060000","060000","060000","060000","060000","060000","060000","060000","060000","060000","060000","060000","060000","060000","060000","060000","060000","060000","060000","060000","060000","060000","060000","060000","060000","060000","060000","060000","060000","040000","040000"],
["060000","060000","060000","060000","060000","060000","060000","060000","060000","060000","060000","060000","060000","060000","060000","060000","060000","060000","060000","060000","060000","060000","060000","060000","060000","060000","060000","060000","060000","060000","060000","060000","060000","060000","060000","060000","060000","060000","060000","060000","060000","060000","060000","060000","060000","060000","060000","060000","040000","040000"],
["060000","060000","060000","060000","060000","060000","060000","060000","060000","060000","060000","060000","060000","060000","060000","060000","060000","060000","060000","060000","060000","060000","060000","060000","060000","060000","060000","060000","060000","060000","060000","060000","060000","060000","060000","060000","060000","060000","060000","060000","060000","060000","060000","060000","060000","060000","060000","060000","040000","040000"],
["060000","060000","060000","060000","060000","060000","060000","060000","060000","060000","060000","060000","060000","060000","060000","060000","060000","060000","060000","060000","060000","060000","060000","060000","060000","060000","060000","060000","060000","060000","060000","060000","060000","060000","060000","060000","060000","060000","060000","060000","060000","060000","060000","060000","060000","060000","060000","060000","040000","040000"],
["060000","060000","060000","060000","060000","060000","060000","060000","060000","060000","060000","060000","060000","060000","060000","060000","060000","060000","060000","060000","060000","060000","060000","060000","060000","060000","060000","060000","060000","060000","060000","060000","060000","060000","060000","060000","060000","060000","060000","060000","060000","060000","060000","060000","060000","060000","060000","060000","040000","040000"],
["060000","060000","060000","060000","060000","060000","060000","060000","060000","060000","060000","060000","070000","060000","060000","060000","060000","060000","060000","060000","060000","060000","060000","060000","060000","060000","060000","060000","060000","060000","060000","030000","030000","030000","060000","060000","060000","060000","060000","060000","060000","060000","060000","060000","060000","060000","060000","060000","040000","040000"],
["060000","060000","060000","060000","060000","060000","060000","060000","060000","060000","060000","070000","070000","070000","060000","060000","060000","060000","060000","060000","060000","060000","060000","060000","060000","060000","060000","060000","060000","060000","060000","030000","030000","030000","060000","060000","060000","060000","060000","060000","060000","060000","060000","060000","060000","060000","060000","060000","040000","040000"],
["060000","060000","060000","060000","060000","060000","060000","060000","060000","060000","060000","070000","070000","070000","060000","060000","060000","060000","060000","060000","060000","060000","060000","060000","060000","060000","060000","060000","060000","060000","060000","030000","030000","030000","060000","060000","060000","060000","060000","060000","060000","060000","060000","060000","060000","060000","060000","060000","040000","040000"],
["060000","060000","060000","060000","060000","060000","060000","060000","060000","060000","060000","060000","070000","060000","060000","060000","060000","060000","060000","060000","060000","060000","060000","060000","060000","060000","060000","060000","060000","060000","060000","060000","060000","060000","060000","060000","060000","060000","060000","060000","060000","060000","060000","060000","060000","060000","060000","060000","040000","040000"],
["060000","060000","060000","060000","060000","060000","060000","060000","060000","060000","060000","060000","060000","060000","060000","060000","060000","060000","060000","060000","060000","060000","060000","060000","060000","060000","060000","060000","060000","060000","060000","060000","060000","060000","060000","060000","060000","060000","060000","060000","060000","060000","060000","060000","060000","060000","060000","060000","040000","040000"],
["060000","060000","060000","060000","060000","060000","060000","060000","060000","060000","060000","060000","060000","060000","060000","060000","060000","060000","060000","060000","060000","060000","060000","060000","060000","060000","060000","060000","060000","060000","060000","060000","060000","060000","060000","060000","060000","060000","060000","060000","060000","060000","060000","060000","060000","060000","060000","060000","040000","040000"],
["060000","060000","060000","060000","060000","060000","060000","060000","060000","060000","060000","060000","060000","060000","060000","060000","060000","060000","060000","060000","060000","060000","060000","060000","060000","060000","060000","060000","060000","060000","060000","060000","060000","060000","060000","060000","060000","060000","060000","060000","060000","060000","060000","060000","060000","060000","060000","060000","040000","040000"],
["060000","060000","060000","060000","060000","060000","060000","060000","060000","060000","060000","060000","060000","060000","060000","060000","060000","060000","060000","060000","060000","060000","060000","060000","060000","060000","060000","060000","060000","060000","060000","060000","060000","060000","060000","060000","060000","060000","060000","060000","060000","060000","060000","060000","060000","060000","060000","060000","040000","040000"],
["060000","060000","060000","060000","060000","060000","060000","060000","060000","060000","060000","060000","060000","060000","060000","060000","060000","060000","060000","060000","060000","060000","060000","060000","060000","060000","060000","060000","060000","060000","060000","060000","060000","060000","060000","060000","060000","060000","060000","060000","060000","060000","060000","060000","060000","060000","060000","060000","040000","040000"],
["060000","060000","060000","060000","060000","060000","060000","060000","060000","060000","060000","060000","060000","060000","060000","060000","060000","060000","060000","060000","060000","060000","060000","060000","060000","060000","060000","060000","060000","060000","060000","060000","060000","060000","060000","060000","060000","060000","060000","060000","060000","060000","060000","060000","060000","060000","060000","060000","040000","040000"],
["060000","060000","060000","060000","060000","060000","060000","060000","060000","060000","060000","060000","060000","060000","060000","060000","060000","060000","060000","060000","060000","060000","060000","060000","060000","060000","060000","060000","060000","060000","060000","060000","060000","060000","060000","060000","060000","060000","060000","060000","060000","060000","060000","060000","060000","060000","060000","060000","040000","040000"],
["060000","060000","060000","060000","060000","060000","060000","060000","060000","060000","060000","060000","060000","060000","060000","060000","060000","060000","060000","060000","060000","060000","060000","060000","060000","060000","060000","060000","060000","060000","060000","060000","060000","060000","060000","060000","060000","060000","060000","060000","060000","060000","060000","060000","060000","060000","060000","060000","040000","040000"],
["060000","060000","060000","060000","060000","060000","060000","060000","060000","060000","060000","060000","060000","060000","060000","060000","060000","060000","060000","060000","060000","060000","060000","060000","060000","060000","060000","060000","060000","060000","060000","060000","060000","060000","060000","060000","060000","060000","060000","060000","060000","060000","060000","060000","060000","060000","060000","060000","040000","040000"],
["060000","060000","060000","060000","060000","060000","060000","060000","060000","060000","060000","060000","060000","060000","060000","060000","060000","060000","060000","060000","060000","060000","060000","060000","060000","060000","060000","060000","060000","060000","060000","060000","060000","060000","060000","060000","060000","060000","060000","060000","060000","060000","060000","060000","060000","060000","060000","060000","040000","040000"],
["060000","060000","060000","060000","060000","060000","060000","060000","060000","060000","060000","060000","060000","060000","060000","060000","060000","060000","060000","060000","060000","060000","060000","060000","060000","060000","060000","060000","060000","060000","060000","060000","060000","060000","060000","060000","060000","060000","060000","060000","060000","060000","060000","060000","060000","060000","060000","060000","040000","040000"],
["060000","060000","060000","060000","060000","060000","060000","060000","060000","060000","060000","060000","060000","060000","060000","060000","060000","060000","060000","060000","060000","060000","060000","060000","060000","060000","060000","060000","060000","060000","060000","060000","060000","060000","060000","060000","060000","060000","060000","060000","060000","060000","060000","060000","060000","060000","060000","060000","040000","040000"],
["060000","060000","060000","060000","060000","060000","060000","060000","060000","060000","060000","060000","060000","060000","060000","060000","060000","060000","060000","060000","060000","060000","060000","060000","060000","060000","060000","060000","060000","060000","060000","060000","060000","060000","060000","060000","060000","060000","060000","060000","060000","060000","060000","060000","060000","060000","060000","060000","040000","040000"],
["060000","060000","060000","060000","060000","060000","060000","060000","060000","060000","060000","060000","060000","060000","060000","060000","060000","060000","060000","060000","060000","060000","060000","060000","060000","060000","060000","060000","060000","060000","060000","060000","060000","060000","060000","060000","060000","060000","060000","060000","060000","060000","060000","060000","060000","060000","060000","060000","040000","040000"]]
